10 11 11
.
OOOOOOOOOO
OOOOOOOOOO
OOOOOOOOOO
OOOOOOOOOO
OOOOOOOOMM
OOOOOOOOMM
OOOOOOOOMO
OOOOOOOOMO
OOOOO2222O
OOOOOOOOOO
OOOOOOOOOO
.
OOOOOOOOOO
OOOOOOOOOO
OOOOOOOOOO
OOOOOOOOOO
OOOOOOOOOO
OOOOOOOOOO
OOOOOOOOOO
OOOOOOOOOO
OOOOOOOOOO
OOOOOOOOOO
OOOOOOOOOO
.
MMIIIIOOOO
OOOOOIOOOO
OOOOOIIIIO
OOOOOOOOOO
OOOOOOOOOO
OOOOOOOOOO
OOOOOOOOOO
OOOOOOOOOO
OOOOCOOOOO
OOOOOOOOOO
OOOOOOOOOO
.
MOOOOOOOOO
OOOOOOOOOO
OOOOOOOOOO
OOOOOOOOOO
OOOOOOOOOO
IOOOOOOOOO
IOOOOOOOOO
IOOMMMOOOO
IIIMMMOOOO
OOOOOOOOOO
OOOOOOOOOO
.
OOOOOOOOOO
OOOOOOOOOO
OOOOOOOOII
OOOOOOOOOI
OOOOOOOOOI
OOOOOOOOOO
OOOOOOOOOO
OOOOOCOOOO
OOOOOMOOOO
OOOOOOOOOO
OOOOOOOOOO
.
OOOOOOOOOO
OOOOOOOOOO
OOOOOOOOCO
OOOOOOOOOO
OOOOOOOOOO
OOOOOOOOOO
OOOOOOOOOO
OOOOOOOOOO
OOOOOMOOOO
OOOOOOOOOO
OOOOOOOOOO
.
OOOOOOOOOO
OOOOOOOOOO
OOOOOOOOOO
HOOOOOOOOO
HOOOOOOOOO
HOOHHHHHOO
OOOHHHHHOO
OOOHHOHHOO
OOOHHMHHOO
OOOOOOOOOO
OOOOOOOOOO
.
OOOOOOOOOO
OOOOOOOOOO
HOOOOOOOOO
MOOOOOOOOO
MOOOOOOOOO
MOOMMMMMOO
OOOMMMMMOO
OOOMMOMMOO
OOOMMMMMOO
OOOOOOOOOO
OOOOOOOOOO
.
COOOOOOOOO
HOOOOOOOOO
MOOOOIIIOO
MOOOOIOOOO
MOOOOOOOOO
MOOMOOOMOO
OOOMOOOMOO
OOOMOOOMOO
OOOMMMMMOO
OOOOOOOOOO
OOOOOOOOOO
.
HOOOOOOOOO
MOOOOOOOOO
MOOOOOOOOO
MOOOOOOOOO
MOOOOOOOOO
MOOMOOOMOO
OOOMOPOMOO
OOOMOOOMOO
COOMMMMMOO
OOOOOOOOOO
OOOOOQOOOO
.
MOOOOOOOOO
MOOOOOOOOO
MOOOOOOIIO
MOOOOIOOOO
MOOOOIOOOO
MOOMMMMMOO
OOOMMMMMOO
OOOMMMMMOO
MOOMMMMMOO
IOOOOOOOOO
IIIIIIOOOO