13 10 8
.
OOOOOOOOOOOOO
OOOOOOOOOOOOO
OOOOOOOOOOOOO
OOOOOOOOOOOOO
OOOOOOOOOOOOO
OOOOOOPOOOOOO
OOOOOOOOOOOOO
OOOOOOOOOOOOO
OOOOOOOOOOOOO
OOOOOOOOOOOOO
.
OOOOOOOOOOOOO
OOOOOOOOOOOOO
OOOOOOOOOOOOO
OOOOOOOOOOOOO
OOOOOOOOOOOOO
OOOOOOOOOOOOO
OOOOOOOOOOOOO
OOOOOOOOOOOOO
OOOOOOOOOOOOO
OOOOOOOOOOOOO
.
OOOOOOOOOOOOO
OOOOOOOOOOOOO
OOOOOOOOOOOOO
OOOOOOOOOOOOO
OOOOOOOOOOOOO
OOOOOOOOOOOOO
OOOOOOOOOOOOO
OOOOOOOOOOOOO
OOOOOOOOOOOOO
OOOOOOOOOOOOO
.
OOOOOOOOOOOOO
OOOOOOOOOOOOO
OOOOOOOOOOOOO
OOOOOOOOOOOOO
OOOOOOOOOOOOO
OOOOOOOOOOOOO
OOOOOOOOOOOOO
OOOOOOOOOOOOO
OOOOOOOOOOOOO
OOOOOOOOOOOOO
.
OOOOOOOOOOOOO
OOOOOOOOOOOOO
OOOOOOOOOOOOO
OOOOOOOOOOOOO
OOOOOOOOOOOOO
OOOOOOOOOOOOO
OOOOOOOOOOOOO
OOOOOOOOOOOOO
OOOOOOOOOOOOO
OOOOOOOOOOOOO
.
OOOOOOOOOOOOO
OOOOOOOOOOOOO
OOOOOOOOOOOOO
OOOOOOOOOOOOO
OOOOOOOOOOOOO
OOOOOOOOOOOOO
OOOOOOOOOOOOO
OOOOOOOOOOOOO
OOOOOOOOOOOOO
OOOOOOOOOOOOO
.
OOOOOOOOOOOOO
OOOOOOOOOOOOO
OOOOOOOOOOOOO
OOOOOOOOOOOOO
OOOOOOOOOOOOO
OOOOOOOOOOOOO
OOOOOOOOOOOOO
OOOOOOOOOOOOO
OOOOOOOOOOOOO
OOOOOOOOOOOOO
.
2222222222222
2222222222222
2222222222222
2222222222222
2222222222222
2222222222222
2222222222222
2222222222222
2222222222222
2222222222222
