13 10 7
.
OOOOOOOOOOOOO
OOOOOOOOOOOOO
OOOOOOOOOOOOO
OOOOOOOOOOOOO
OOOOTTTOOOOOO
OOOOTTTOOOOOO
OOOOTTTOOOOOO
OOOOOOOOOOOOO
OOOOOOOOOOOOO
OOOOOOOOOOOOO
.
OOOOOOOOOOOOO
OOOOOOOOOOOOO
OOTTTOOOOOOOO
OOTTTTOOOOOOO
OOTTTTTOOOOOO
OOOTTCTTOOOOO
OOOOTTTTTOOOO
OOOOOTTTTOOOO
OOOOOOTTTOOOO
OOOOOOOOOOOOO
.
OOOOOOOOOOOOO
OOOOOOOOOOOOO
OOHOOOOOOOOOO
OOOOOOOOOOOOO
OOOOOOOOOOOOO
OOOOOOOOOOOOO
OOOOOOOOOOOOO
OOOOOOOOOOOOO
OOOOOOOOHOOOO
OOOOOOOOOOOOO
.
OOOOOOOOOOOOO
OOOOOOOOOOOOO
OOHOOOOOOOOOO
OOOOOOOOOOOOO
OOOOOOOOOOOOO
OOOOOOOOOOOOO
OOOOOOOOOOOOO
OOOOOOOOOOOOO
OOOOOOOOHOOOO
OOOOOOOOOOOOO
.
OOOOOOOOOOOOO
OHHSOOOOOOOOO
OHHSOOOOOOOOO
OSSOOOOOOOOOO
OOOOOOOOOOOOO
OOOOOOOOOOOOO
OOOOOOOOOOOOO
OOOOOOOOOOCCO
OOOOOOOOHOCCO
OOOOOOOOOOOOO
.
OOOOOOOOOOOOO
OHHHSOOOOOOOO
OHHHSOOOOOOOO
OHHOOOOOOOOOO
OSSOOOOWWWWWO
OOOOOOOWHHHWO
OOOOOOOWHHHWO
OOOOOOOWHHHWO
OOOOOOOWWWWWO
OOOOOOOOOOOOO
.
OOOOOOOOOOOOO
OOOOOOOOOOOOO
OOOOOOOOOOOOO
OOOOOOOOOOOOO
OOOOOOOOOOOOO
OOOOOOOOOOOOO
OOOOOOOOOCOOO
OOOOOOOOOOOOO
OOOOOOOOOOOOO
OOOOOOOOOOOOO
