9 9 5
.
HHHHHHHHH
HHHHHHHHH
HHHHHHHHH
HHHHHHHHH
HHHHHHHHH
HHHHHHHHH
HHHHHHHHH
HHHHHHHHH
HHHHHHHHH
.
OOOOOOOOO
OOOOOOOOO
OOOOOOOOO
OOOOOOOOO
OOOOOOOOO
OOOOOOOOO
OOOOOOOOO
OOOOOOOOO
OOOOOOOOO
.
XOOOOOOOO
OOOOOOOOO
OOOOOOOOO
OOOOOOOOO
OOOOOOOOO
OOOOOOOOO
OOOOOOOOO
OOOOOOOOO
OOOOOOOOO
.
HHHHHHHHH
HHHHHHHHH
HHOOOOOHH
HHOOOOOHH
HHOOPOOHH
HHOOOOOHH
HHOOOOOHH
HHHHHHHHH
HHHHHHHHH
.
HHHHHHHHH
HHHHHHHHH
HHHHHHHHH
HHHHHHHHH
HHHHHHHHH
HHHHHHHHH
HHHHHHHHH
HHHHHHHHH
HHHHHHHHH