13 10 8
.
OOOOOOOOOOOOO
OOOOOOOOOOOOO
OOPOOOOOOOOOO
OOOOOOOOOOOOO
OOOOOOOOOOOOO
OOOOO1OOOOOOO
OOOOOOOOOOOOO
OOOOOOOOOOOOO
OOOOOOOO22OOO
OOOOOOOOOOOOO
.
OOOOOOOOOOOOO
OOOOOOOOOOOOO
OOOOOOOOOOOOO
OOOOOOOOOOOOO
OOOOOOOOOOOOO
OOOOOOOOOOOOO
OOOOOOOOOOOOO
OOOOOOOOOOOOO
OOOOOOOOOOOOO
OOOOOOOOOOOOO
.
OOOOOOOOOOOOO
OOOOOOOOOOOOO
OOHHHOOOOOOOO
OOHHHHOOOOOOO
OOHHHHHOOOOOO
OOOHHCHHOOOOO
OOOOHHHHHOOOO
OOOOOHHHHOOOO
OOOOOOHHHOOOO
OOOOOOOOOOOOO
.
OOOOOOOOOOOOO
OOOOOOOOOOOOO
OOHOOOOOOOOOO
OOOOOOOOOOOOO
OOOOOOOOOOOOO
OOOOOOOOOOOOO
OOOOOOOOOOOOO
OOOOOOOOOOOOO
OOOOOOOOHOOOO
OOOOOOOOOOOOO
.
OOOOOOOOOOOOO
OZOOOOOOOOOOO
OOHOOOOOOOOOO
OOOOOOOOOOOOO
OOOOOOOOOOOOO
OOOOOOOOOOOOO
OOOOOOOOOOOOO
OOOOOOOOOOOOO
OOOOOOOOHOOOO
OOOOOOOOOOOOO
.
OOOOOOOCOOOOO
OHHOOOOOOOOOO
OH1OOOOOOOOOO
OOOOOOOOOOOOO
OOOOOCOOOOOQO
OOOOOOOOOOOOO
OOOOOOOOOOOOO
OOOOOOOOOOOOO
OOOOOOCXHOOOO
OOOOOOOOOOOOO
.
OOOOOOOIIIIIO
OHHHOOOOOOOIO
OHCHOOOOOOOIO
OHHOOOOOOOOIO
OOOOO1OHHHHHO
OOOOO1OHHHHHO
OOOOOOOHHHHHO
OOOOOOOHHHHHO
OOOOOO1HHHHHO
OOOOOOOOOOOOO
.
OOOOOOOOOOOOO
OOOOOOOOOOOOO
OO2OOOOOOOOOO
OOOOOOOOOOOOO
OOOOOOOOOOOOO
OOOOOOOOOOOOO
OOOOOOOOOOOOO
OOOOOOOOOOOOO
OOOOOOOOOOOOO
OOOOOOOOOOOOO
