12 13 16
.
OOOOOOOOOOOO
MMOOOOOOOOOO
MOOOOOOOOOOO
MOOOOOOOOOOO
MOOOOOOOOOOO
MOOOOOOOOOOO
MOOOOOOOOOOO
MOOOOOOOOOOO
MOOOOOOOOOOO
MOOOOOOOOOOO
OOOOOOOOOOOO
OOOOOMMMOOOO
OOOOOMOOOOOO
.
OOOOOOOOOOOO
OOOOOOOOOOOO
OOOOOOOOOOOO
OOOOOOOOOOOO
OOOOOOOOOOOO
OOOOOOOOOOOO
OOOOOOOOOOOO
OOOOOOOOOOOO
OOOOOOOOOOOO
OOOOOOOOOOOO
OOOOOOOOOOOO
OOOOOOOOOOOO
OOOOOOOOOOOO
.
OOOOOOOOOOOO
OOOOOOOOOOOO
OOOOOOOOOOOO
OOOOOOOOOOOO
OOOOOOOOOOOO
OOOOOOOOOOOO
OOOOOOOOOOOO
OOOOOOOOOOOO
OOOOOOOOOOOO
OOOOOOOOOOOO
OOOOOOOOOOOO
OOOOOOOOOOOO
OOOOOOOOOOOO
.
OOOOOOOOOOOO
OOOOOOOOOOOO
OOOOOOOOOOOO
OOOOOOOOOOOO
OOOOOOOOOOOO
HOOOOOOOOOOO
HOOOOOOOOOOO
OOOOOOOOOOOO
OOOOOOOOOOOO
OOOOOOOOOOOO
OOOOOOOOOOOO
OOOOOOOOOOOO
OOOOOCOOOOOO
.
OOOOOOOOOOOO
OOOOOOOOOOOO
OOOOOOOOOOOO
OOOOOOOOOOOO
H111IIOOOOOO
OOOOOIOOOOOO
OOOOOIOOOOOO
OOOOO1OOOOOO
OOOOO111OOOO
OOOOOOO1OOOO
OOOOOOO1OOOO
OOOOOOO1OOOO
OOOOO1OOOOOO
.
HHHOOOOOOOOO
HOHHHOOOOOOO
HHHOOOOOOOOO
OOOOOOOOOOOO
MOOOOOOOOOOO
COOOOOOOOOOO
2OOOOOOOOOOO
OOOOOOOOOOOO
OOOOOOOOOOOO
OOOOOOOOOOOO
OOOOOOOOOOOO
OOOOOOOOOOOO
OOOOOOOOOOOO
OOOOOOOOOOOO
.
OOOOOOOOOOOO
OOOOOOOOOOOO
OOOOOOOOOOOO
OOOOOOOOOOOO
MOOOOOOOOOOO
HOOOOOOOOOOO
MOOOOOOOOOOO
MOOOOOOOOOOO
OOOOOOOOOOOO
OOOOOOOOOOOO
OOOOOOOOOOOO
OOOOOOOOOOOO
OOOOOOOOOOOO
.
OOOOOOOOOOOO
OOOOOOOOOOOO
OOOOOOOOOOOO
OOOOOOOOOOOO
OOOOOOOOOOOO
OOOOOOOOOOOO
OOOOOOOOOOOO
OOOOOOOOOOOO
OOOOOOOOOOOO
OOOOOOOOOOOO
OOOOOOOOOOOO
OOOOOOOOOOOO
OOOOOOOOOOOO
.
OOOOOOOOOOOO
OZOOO1OOOOOO
OOOOOIOOOOOO
OOOOOOOOOOOO
OOOOOOOOOOOO
OOOOOOOOOOOO
OOOOOOOOOOOO
OOOOOOOOOOOO
OOOOOOOOOOOO
OOOOOOOOOOOO
OOOOOOOOOOOO
OOOOOOOOOOOO
OOOOOOOOOOOO
.
OOOOOOOOOOOO
OHOOOOOOOOOO
OOOOOOOOOOOO
OOOOOIOOOOOO
OOOOOOOOOOOO
OOOOOOOOOOOO
OOOOOOOOOOOO
OOOOOOOOOOOO
OOOOOOOOOOOO
OOOOOOOOOOOO
OOOOOOOOOOOO
OOOOOOOOOOOO
OOOOOOOOOOOO
.
OOOOOOOOOOOO
OOOOOOOOOOOO
OOOOOOOOOOOO
OOOOOOOOOOOO
OOOOOIOOOOOO
2OOOOOOOOOOO
2OOOOOOOOOOO
OOOOOOOOOOOO
OOOOOOOOOOOO
OOOOOOOOOOOO
OOOOOOOOOOOO
OOOOOOOOOOOO
OOOOOPOOOOOO
.
OOOOOOOOOOOO
OOOOOOOOOOOO
OOOOOOOOOOOO
OOOOOOOOOOOO
OOOOOOOOOOOO
OOOOOOOOOOOO
OOOOOOOOOOOO
IOOOOOOOOOOO
2OOOOOOOOOOO
2OOOOOOOOOOO
2OOOOOOOOOOO
OOOOOOOOOOOO
OOOOOMOOOOOO
.
OOOOOOOOOOOO
OOOOOOOOOOOO
OOOOOOOOOOOO
OOOOOOOOOOOO
OOOOOOOOOOOO
OOOOOOOOOOOO
OOOHOOOHOOOO
OOOHHHHHOOOO
OOOHHHHHOOOO
OOOHHHHOOOOO
OOOHHHHOOOOO
OOOHHHHOOOOO
OOOOOOOOOOOO
.
OOOOOOOOOO1C
OOOOOOOOOOOO
OOOOOOOOOOOO
OOOOOOOOOOOO
OOOOOOOOOOOO
OOOOOOOOOOOO
OOOMOOOMOOOO
OOOMOCOMCOOO
OOOHOQOMOOOO
OOOHMMHOOOOO
OOOHQOHOOOOO
OOOHOOHOOOOO
OOOOOOOOOOOO
.
OOOOOOOOOHHH
OOOOOOOOOHOO
OOOOOOOOOHOO
OOOOOHHHHHOO
OOOOOHOOOOOO
OOOOOHOOOOOO
OOOMHHHMOOOO
OOOMMMMMHOOO
OOOMMMMMHOOO
OOOMHHMOIOOO
2OOMHHMOIOOO
2OOMHHMOIOOO
22HHMHHIIOOO