13 10 7
.
OOOOOOOOOOOOO
OOOOOOOOOOOOO
OOOOOOOOOOOOO
OOOOOOOOOOOOO
OOOOTTTOOOOOO
OOOOTTTOOOOOO
OOOOTTTOOOOOO
OOOOOOOOOOOOO
OOOOOOOOOOOOO
OOOOOOOOOOOOO
.
OOOOOOOOOOOOO
OOOOOOOOOOOOO
OOTTTOOOOOOOO
OOTTTTOOOOOOO
OOTTTTTOOOOOO
OOOTTCTTOOOOO
OOOOTTTTTOOOO
OOOOOTTTTOOOO
OOOOOOTTTOOOO
OOOOOOOOOOOOO
.
OOOOOOOOOOOOO
OOOOOOOOOOOOO
OOHOOOOOOOOOO
OOOOOOOOOOOOO
OOOOOOOOOOOOO
OOOOOOOOOOOOO
OOOOOOOOOOOOO
OOOOOOOOOOOOO
OOOOOOOOHOOOO
OOOOOOOOOOOOO
.
OOOOOOOOOOOOO
OQOOOOOOOOOOO
OOHOOOOOOOOOO
OOOOOOOOOOOOO
OOOOOOOOOOOOO
OOOOOOOOOOOOO
OOOOOOOOOOOOO
OOOOOOOOO22OO
OOOOOOOOH22OO
OOOOOOOOOOOOO
.
OOOOOOOOOOOOO
OHHSOOOOOOOOO
OHHSOOOOOOOOO
OSSOOOOOOOOOO
OOOOOCOOOOOOO
OOOOOOOOOOOOO
OOOOOOOOOOZOO
OOOOOOOOO2CCO
OOOOOOCXH2CCO
OOOOOOOOOOOOO
.
OOOOOOOOOOOOO
OHHHSOOOOOOOO
OHHHSOOOOOOOO
OHH11OOOOOOOO
OSSO12OWWWWWO
OOOOOOOWHHHWO
OOOOOOOWHHHWO
OOOOOOOWHHHWO
OOOOOO1WWWWWO
OOOOOOOOOOOOO
.
OOOOOOOOOOOOO
OOOOOOOOOOOOO
OOOOOOOOOOOOO
OOOOOOOOOOOOO
OOOOOOOOOOOOO
OOOOOOOOOOOOO
OOOOOOOOOCOOO
OOOOOOOOOOOOO
OOOOOOOOOOOOO
OOOOOOOOOOOOO
