10 10 3
.
OOOOOOOOOO
OOOOOOOOOO
OOOOOOOOOO
OOOOOOOOOO
OOOOOOOOOO
OOOOOOOOOO
OOOOOOOOOO
OOOOOOOOOO
OOOOOOOOOO
OOOOOOOOOO
.
QOOOOOZOOO
OOOOZOOOQO
OOOOOOOOOO
OOQOOOOOOO
OOOOOOOOOO
OOOOOOOOOO
OOOOOOOOOO
OOOOOOOOOO
OZOOOOOOZO
POOOOOOOOO
.
222222111O
11111OOO2O
OOOO2OOO2O
O1222OOO2O
O1OOOOOO2O
O1OOOOOO2O
O1OOOOOO2O
O1OOOOOO2O
HHOOOOOO1O
HH1111111O
