13 10 8
.
OOOOOOOOOOOOO
OOOOOOOOOOOOO
OOPOOOOOOOOOO
OOOOOOOOOOOOO
OOOOOOOOOOOOO
OOOOO1OOOOOOO
OOOOOOOOOOOOO
OOOOOOOOOOOOO
OOOOOOOO22OOO
OOOOOOOOOOOOO
.
OOOOOOOOOOOOO
OOOOOOOOOOOOO
OOOOOOOOOOOOO
OOOOOOOOOOOOO
OOOOOOOOOOOOO
OOOOOOOOOOOOO
OOOOOOOOOOOOO
OOOOOOOOOOOOO
OOOOOOOOOOOOO
OOOOOOOOOOOOO
.
OOOOOOOOOOOOO
OOOOOOOOOOOOO
OOTTTOOOOOOOO
OOTTTTOOOOOOO
OOTTTTTOOOOOO
OOOTTCTTOOOOO
OOOOTTTTTOOOO
OOOOOTTTTOOOO
OOOOOOTTTOOOO
OOOOOOOOOOOOO
.
OOOOOOOOOOOOO
OOOOOOOOOOOOO
OOHOOOOOOOOOO
OOOOOOOOOOOOO
OOOOOOOOOOOOO
OOOOOOOOOOOOO
OOOOOOOOOOOOO
OOOOOOOOOOOOO
OOOOOOOOHOOOO
OOOOOOOOOOOOO
.
OOOOOOOOOOOOO
OQOOOOOOOOOOO
OOHOOOOOOOOOO
OOOOOOOOOOOOO
OOOOOOOOOOOOO
OOOOOOOOOOOOO
OOOOOOOOOOOOO
OOOOOOOOOOOOO
OOOOOOOOHOOOO
OOOOOOOOOOOOO
.
OOOOOOOCOOOOO
OHHOOOOOOOOOO
OH1OOOOOOOOOO
OOOOOOOOOOOOO
OOOOOCOOOOOZO
OOOOOOOOOOOOO
OOOOOOOOOOOOO
OOOOOOOOOOOOO
OOOOOOCXHOOOO
OOOOOOOOOOOOO
.
OOOOOOOIIIIIO
OHHHOOOOOOOIO
OHCHOOOOOOOIO
OHHOOOOOOOOIO
OOOOO1OWWWWWO
OOOOO1OWHHHWO
OOOOOOOWHHHWO
OOOOOOOWHHHWO
OOOOOO1WWWWWO
OOOOOOOOOOOOO
.
OOOOOOOOOOOOO
OOOOOOOOOOOOO
OO2OOOOOOOOOO
OOOOOOOOOOOOO
OOOOOOOOOOOOO
OOOOOOOOOOOOO
OOOOOOOOOOOOO
OOOOOOOOOOOOO
OOOOOOOOOOOOO
OOOOOOOOOOOOO
