13 13 12
.
HHHHHHHOOOOOO
HHHHHHHOOOOOO
HHHHHOOOOOOOO
HHOOOOOOOOOOO
OOOOOOOOOOOOO
OOOOOOOOOOOOO
OOOOOOOOOOOOO
OOOOOOOOOOOOO
OOOOOOOOOOOOO
OOOOOOOOOOOOO
OOOOOOOOOOOOO
OOOOOOOOOOOOO
OOOOOOOOOOOOO
.
MMMMMMMOOOOOO
MMMMMMMOOOOOO
MMMMOOOOOOOOO
MMOOOOOOOOOOO
OOOOOOOOOOOOO
OOOOOOOOOOOOO
OOOOOOOOOOOOO
OOOOOOOOOOOOO
OOOOOOOOOOOOO
OOOOOOOOOOOOO
OOOOOOOOOOOOO
OOOOOOOOOOOOO
OOOOOOOOOOOOO
.
MMMMMOOOOOOOO
OOMOOOOOOOOOO
OOOOOOOOOOOOO
OOOOOOOOOOOOO
OOOOOOOOOOOOO
OOOOOOOOOOOOO
OOOOOOOOOOOOO
OOOOOOOOOOOOO
OOOOOOOOOOOOO
OOOOOOOOOOOOO
OOOOOOOOOOOOO
OOOOOOOOOOOOO
OOOOOOOOOOOOO
.
MMMMMOOOOOOOO
OCMMOOOOOOOOO
OOOOOOOOOOOOO
OOOOOOOOOOOOO
OOOOOOOOOOOOO
OOOOOOOOOOOOO
OOOOOOOOOOOOO
OOOOOOOOOOOOO
OOOOOOOOOOOOO
OOOOOOOOOOOOO
OOOOOOOOOOHHH
OOOOOOOOOOOOO
OOOOOOOOOOOOO
.
MMMMMOOOOOOOO
MMMMOOOOOOOOO
MMOOOOOOOOOOO
OOOOOOOOOOOOO
OOOOOOOOOOOOO
OOOOOOOOOOOOO
OOOOOOOOOOOOO
OOOOOOOOOOOOO
OOOOOOOOOOHHH
OOOOOOOOOOHHH
OOOOOOOOOCMMM
OOOOOOOOOOOOO
OOOOOOOOOOOOO
.
MMMMMHHHHHHHH
MMMMHHHHHHHHH
MMOOHHHHHHHHH
HHOOHHHHHHHHH
HHHHHHHHHHHHH
OOOOOOOOOOWWO
OOOOOOOOOOWWO
OOOOOOOOOHWWO
OOOOOOOOOHMMM
OOOOOOOOOHMMM
OOOOOOOOOHMMM
OOOOOOOOOOOOO
OOOOOOOOOOOOO
.
MMMMMMMMMMMMM
MMMMMMMMMMMMM
MMOOMMMMMMMMM
MMOOMMMMMMMMM
MMMMMMMMMMMMM
OOOOOOOOOOOOO
OOOOOOOOOOOOO
OOOOOOOOOMCOO
OOOOOOOOOMMMM
OOOOOOOOOMMMM
OOOOOOOOOMMMM
OOOOOOOOOOOOO
OOOOOOOOOOOOO
.
MMMMMMMMMMMMM
MMMMMMMMMMMMM
MMOOMMMMMMMMM
MMOOMMMMMMMMM
MMMMMMMMMMMMM
OOOOOOOOOOOOO
OOOOOOOOOOOOO
OOOOOOOOOMOOO
OOOOOOOOOMMMM
OOOOOOOOOMMOM
OOOOOOOOOMMOM
OOOOOOOOOOOOO
OOOOOOOOOOOOO
.
MMMMMMMMMMMMM
MMMMMMMMMMMMM
MMOOMMMMMMMMM
MMOOMMMMMMMMM
MMMMMMMMMMMMM
OOOOOOOOOOOOO
OOOOOOOOOOOOO
OOOOOOOOOMOOM
OOOOOOOOOMMMM
OOOOOOOOOMMOM
OOOOOOOOOMMOM
OPOOOOOOOOOOO
OOOOOOOOOOOOO
.
MMMMMMMMMMMMM
MMMMMMMMMMMMM
MMOOMMMMMMMMM
MMOOMMMMMMMMM
MMMMMMMMMMMMM
HHHHHHHHHHHHH
HHHHHHHHHHHHH
HHHHHHHHHHHHH
HHHHHHHHHHHHH
HHOOHHHHHHHOH
HHOOHHHHHHHHH
HHHHHHHHHHHHH
HHHHHHHHHHHHH
.
MMMMMMMMMMMMM
MMMMMMMMMMMMM
MMOOMMMMMMMMM
MMOOMMMMMMMMM
MMOOMMMMMMMMM
MMOOMMMMMMOOO
MMOOMMMMMMOOO
MOOOMMMMMMOOO
MMOOMMMMMMOOO
MMOOMMMMMMOOO
MMOOMMMMMMOOO
MMMMMMMMMMMMM
MMMMMMMMMMMMM
.
MMMMMMMMMMMMM
MMMMMMMMMMMMM
MMOOMMMMMMMMM
MMOOMMMMMMMMM
MMOOMMMMMMMMM
MOOOMMMMMMOOO
OOOOMMMMMMOCO
OOOOMMMMMMOOO
OOOOMMMMMMOOO
MMOOMMMMMMOOO
MMOOMMMMMMOOO
MMMMMMMMMMMMM
MMMMMMMMMMMMM
.
MMMMMMMMMMMMM
MMMMMMMMMMMMM
MMOOMMMMMMMMM
MMOOMMMMMMMMM
MMOOMMMMMMMMM
MMOOCMMMMMOOO
MOOOMMMMMMOOO
MOOOMMMMMMOOO
MMOOMMMMMMOOO
MMOOMMMMMMOOO
MMOOMMMMMMOOO
MMMMMMMMMMMMM
MMMMMMMMMMMMM
.
MMMMMMMMMMMMM
MMMMMMMMMMMMM
MMMMMMMMMMMMM
MMMMMMMMMMMMM
MMMMMMMMMMMMM
MMMMMMMMMMMMM
MMMMMMMMMMMMM
MMMMMMMMMMMMM
MMMMMMMMMMMMM
MMMMMMMMMMMHM
MMMMMMMMMMMMM
MMMMMMMMMMMMM
MMMMMMMMMMMMM