11 11 9
.
HHHHHHHHHHH
HHHHHHHHHHH
HHHHHHHHHHH
HHHHHHHHHHH
OOOHOOOOOOO
OOOHOOOOO2O
OOOHOOOOOOO
HHHHHHHHHHH
HHHHHHHHWWW
HHHHHHHHWWW
HHHHHHHHWWW
.
COOHOOOHOOO
OOOHOOOHOOO
OOOHOOOHOOO
HHHHGGGHHHH
OOOHOOOOOOO
OOOOOOOOOCO
OOOHOOOOOOO
HHHHHHHHHHH
OOOHOOOHOOO
OOOHOOOHOOO
OOOHOOOHOOO
.
OOOHOOOHOOO
OOOHOOOHOOO
OOOHOOOHOOO
HOHHGGGHOOH
OOOHOOOOOOO
OOOOOOOOOOO
OOOHOOOOOOO
HHHHHHHHHHH
OOOHOOOHOOO
OOOHOOOHOOO
OOOHOOOHOOO
.
OOOHOOOHOQO
OOO1OOO2OOO
O2OHOOOHOOO
H1HHGGGHOOH
OOOHOOZHOOO
OOOOOOOHOOO
OOOHOOQHOOO
H2HHH1HHH2H
OOZHOOOHQOO
OOO2OOO1OOO
OOOHOOOHOOO
.
HHHHHHHHHHH
H1HHH2HHHHH
HHHHHHHHHHH
HHHHHHHHHHH
2H1HHHHH111
2H1HHHHH111
2H1HHHHH111
HHHHHHHHHHH
HHHHHHHHHHH
HHHHHHHHHHH
HHHHH2HHHHH
.
OOOHOOOHOOO
OOOHOOOH2OC
OOOHOOOHOOO
HHHHHHHHHHH
O1OHOOOHOOO
O1OHOOOHOOO
O1OHOOOHOOO
HHHHHHHH222
OOOHOOOH222
OOOHOOOHOOO
OOOHOOOHOOO
.
OOOHOOOHIII
OOO1OOOOOII
OOOHOOOHIII
HHHHHHHHHOO
O1OHOOOHOOO
O1CHOOOHOOO
O1OHOOOHOOO
HH1HOOOH111
OOOHOOOHOOO
OOO1OOOOOOO
OOOHOOOOOOO
.
QOOHOOOHOOO
OOO1OZOHOOO
OOOHOOOHOOO
2HHHHHHHHOO
OHHHOOOHOOO
OHHHOCOHOOO
OHHHOOOHOOO
2HHHOOOHHHH
OOHHOOOHOOO
OPHHOOOOOOO
OOOHOOOOOOO
.
HHHHOOOHIII
HHHHWWWHIII
HHHHOOOHIII
HHHHHHHHHHH
HHHHOOOHHHH
HHHHO2OHHHH
HHHHO2OHHHH
HHHHO2OHHHH
HHHHO2OHHHH
HHHHHHHHHHH
HHHHHHHHHHH