13 10 8
.
OOOOOOOOOOOOO
OOOOOOOOOOOOO
OOPOOOOOOOOOO
OOOOOOOOOOOOO
OOOOOOOOOOOOO
OOOOO1OOOOOOO
OOOOOOOOOOOOO
OOOOOOOOOOOOO
OOOOOOOO22OOO
OOOOOOOOOOOOO
.
OOOOOOOOOOOOO
OOOOOOOOOOOOO
OOOOOOOOOOOOO
OOOOOOOOOOOOO
OOOOOOOOOOOOO
OOOOOOOOOOOOO
OOOOOOOOOOOOO
OOOOOOOOOOOOO
OOOOOOOOOOOOO
OOOOOOOOOOOOO
.
OOOOOOOOOOOOO
OOOOOOOOOOOOO
OOHWWOOOOOOOO
OOWWWWOOOOOOO
OOWWWWWOOOOOO
OOOWWCWWOOOOO
OOOOWWWWWOOOO
OOOOOWWWWOOOO
OOOOOOWWHOOOO
OOOOOOOOOOOOO
.
OOOOOOOOOOOOO
OOOOOOOOOOOOO
OOHOOOOOOOOOO
OOOOOOOOOOOOO
OOOOOOOOOOOOO
OOOOOOOOOOOOO
OOOOOOOOOOOOO
OOOOOOOOOOOOO
OOOOOOOOHOOOO
OOOOOOOOOOOOO
.
OOOOOOOOOOOOO
OZOOOOOOOOOOO
OOMOOOOOOOOOO
OOOOOOOOOOOOO
OOOOOOOOOOOOO
OOOOOOOOOOOOO
OOOOOOOOOOOOO
OOOOOOOOOOOOO
OOOOOOOOMOOOO
OOOOOOOOOOOOO
.
OOOOOOOCOOOOO
OHHOOOOOOOOOO
OH1OOOOOOOOOO
OOOOOOOOOOOOO
OOOOOCOOOOOQO
OOOOOOOOOOOOO
OOOOOOOOOOOOO
OOOOOOOOOOOOO
OOOOOOCXMOOOO
OOOOOOOOOOOOO
.
OOOOOOOIIIIIO
OHHHOOOOOOOIO
OHCHOOOOOOOIO
OHHOOOOOOOOIO
OOOOO1OHHHHHO
OOOOO1OHHHHHO
OOOOOOOHHHHHO
OOOOOOOHHHHHO
OOOOOO1HHHHHO
OOOOOOOOOOOOO
.
OOOOOOOOOOOOO
OOOOOOOOOOOOO
OO2OOOOOOOOOO
OOOOOOOOOOOOO
OOOOOOOOOOOOO
OOOOOOOOOOOOO
OOOOOOOOOOOOO
OOOOOOOOOOOOO
OOOOOOOOOOOOO
OOOOOOOOOOOOO
