11 11 9
.
HHHHHHHHHHH
HHHHHHHHHHH
HHHHHHHHHHH
HHHHHHHHHHH
OOOHOOOOOOO
OOOHOOOOO2O
OOOHOOOOOOO
HHHHHHHHHHH
HHHHHHHHWWW
HHHHHHHHWWW
HHHHHHHHWWW
.
COOHOOOHOOO
OOOHOOOHOOO
OOOHOOOHOOO
HHHHHHHHHHH
OOOHOOOOOOO
OOOHOOOOOCO
OOOHOOOOOOO
HHHHHHHHHHH
OOOHOOOHOOO
OOOHOOOHOOO
OOOHOOOHOOO
.
OOOHOOOHOOO
OOOHOOOHOOO
OOOHOOOHOOO
HOHHHHHHOOH
OOOHOOOOOOO
OOOOOOOOOOO
OOOHOOOOOOO
HHHHHHHHHHH
OOOHOOOHOOO
OOOHOOOHOOO
OOOHOOOHOOO
.
OOOHOOOHOQO
OOO1OOO2OOO
O2OHOOOHOOO
H1HHHHHHOOH
OOOHOOZHOOO
OOOOOOOHOOO
OOOHOOQHOOO
H2HHH1HHH2H
OOOHOOOHQOO
OOOOOOO1OOO
OOOHOOOHOOO
.
HHHHHHHHHHH
H2HHH2HHHHH
HHHHHHHHHHH
HHHHHHHHHHH
HHHHHHHH111
H1HHHHHH111
HHHHHHHH111
HHHHHHHHHHH
HHHHHHHHHHH
HHHHHHHHHHH
HHHHH2HHH1H
.
OOOHOOOHOOO
OOOHOOOH2OC
OOOHOOOHOOO
HHHHHHHHHHH
OOOHOOOHOOO
OOOHOOOHOOO
OOOHOOOHOOO
HHHHHHHH222
OOOHOOOHOOO
OOOHOOOHOOO
OOOHOOOHOOO
.
OOOHOOOHIII
OOO1OOOOOII
OOOHOOOHIII
HHHHHHHHHOO
1OOHOOOHOOO
1COHOOOHOOO
1OOHOOOHOOO
HHHHOOOHHHH
OOOHOOOHOOO
OOOHOOOHOOO
OOOHOOOHOOO
.
QOOHOOOHOOO
OOO1OZOHOOO
OOOHOOOHOOO
2HHHHHHHHOO
O1OHOOOHOOO
O1OHOCOHOOO
O1OHOOOHOOO
2H1HOOOHHHH
OOOHOOOHOOO
OPOHOOOHOOO
OOOHOOOOOOO
.
HHHHOOOHIII
HHHHWWWHIII
HHHHOOOHIII
HHHHHHHHHHH
HHHHOOOHHHH
HHHHO2OHHHH
HHHHO2OHHHH
HHHHO2OHHHH
HHHHO2OHHHH
HHHHHHHHHHH
HHHHHHHHHHH