15 15 10
.
OOOOOOOOOOOOOOO
OOOOOOOOOOOOOOO
OOOOOOOOOOOOOOO
OOOOOOOOOOOOOOO
OOOOOOOOOOOOOOO
OOOOOOOOOOOOOOO
OOOOOOOOOOOOOOO
OOOOOOOOOOOOOOO
OOOOOOOOOOOOOOO
OOOOOOOOOOOOOOO
OOOOOOOOOOOOOOO
OOOOOOOOOOOOOOO
OOOOOOOOOOOOOOO
.
OOOOOOOOOOOOOOO
OOOOOOOOOOOOOOO
OOOOPOOOOOOOOOO
OOOOOOCOOOOOOOO
OOOOOOOOOOOOOOO
OOOOOOOOOOOOOOO
OOOOOOOOOOOOOOO
OOOOOOOOOOOOOOO
OOOOOOOOOOOOOOO
OIIIIIIIIIOOOOO
OOOOOOOHHHHOOOO
OOOOOOOHHHHOOOO
OOOOOOOHHHHOOOO
.
OOOOOOOOOOOOOOO
OOOHHHOOOOOOOOO
OOOHHHOOOOOOOOO
OOOHHHIIIIIIOOO
OOOOOOOOOOOOOOO
OOOOOOOOOOOOOOO
OOOOOOOOOOOOOOO
OOOOOOOOOOOOOOO
OOOOOOOOOOOOOOO
OOOOOOOOOOOOOOO
OOOOOOOMMCMOOOO
OOOOOOOMMOMOOOO
OOOOOOOMMMMOOOO
.
OOOOOOOOOOOOOOO
OOOOOOOOOOOOOOO
OOOOMOOOOOOOOOO
OOOOOOOOOOOOOOO
OOOOOOOOOOOOOOO
OOOOOOOOOOOOOOO
OOOOOOOOOOOOOOO
OOOOOOOOOOOOOOO
OOOOOOOOOOOOOOI
OOOOOOOOIIIIOOI
OOOOOOOMMMMIOOI
OOOOOOOMMOMOOOO
OOOOOOOMMMMOOOO
.
OOOOOOOOOOOOOOO
OOOOCOOOOOOOOOO
OOOOMOOOOOOIIIO
OOOOOOIOOOOIHIO
OOOOOOOOOOOIIIO
OOOOOOOOOOOOOIO
OOOOOOOOOOOOOIO
OOOOOOOOOOOOOII
OOOOOOOOOOOOOOI
OOOOOOOOOCOOOOO
OOOOOOOMMMMHHHH
OOOOOOOMMOOOHHH
OOOOOOOMMMMHHHH
.
OOOOOOOOOOOOOOO
OOOIIIOOOOOOOOO
OOOIMIOOOOOOOOO
OOOIIIIOOOOOMOO
OOOOOOOOOOOOOOO
OOOOOOOOOOOOOOO
OOOOOOOOOOOOOOO
OOOOOOOOOOOOOOO
MMMOOOOOOOOOOOO
MOMOOOOOOIOOOOO
MMMOOOOMMMMMMMM
OOOOOOOMMMMMMMM
OOOOOOOMMMMMMMM
.
OOOOOOOOOOOOOOO
OOOOOOOOOOOOOOO
OOOOMOOOOOOOOOO
OOOOOOOOOOOOMOO
OOOOOOOOOOOOOOO
OOOOOOOOOOOOOOO
OOOOOOOOOOOOOOO
OOOOOOOOOOOOOOO
MOMOOOOOOOOOOOO
OCOOOOOOOOOOOOO
MOMOOOOMMMMMMMM
OOOOOOOMMMMMMMM
OOOOOOOMMMMMMMM
.
OOOOOOOOOOOOOOO
OOOOOOOOOOOOOOO
OOOOMOOOOOOOOOO
OOOOOOOOOOOOMOO
OOOOOOOOOOOOOOO
OOOOOOOOOOOOOOO
OOOOOOOOOOOOOOO
OOOOOOOOOOOOOOO
MMMOOOOOOOOOOOO
MIMOOOOOOOOOOOO
MMMOOOOMMMMMMMM
OOOOOOOMMMMMMMM
OOOOOOOMMMMMMMM
.
OOOOOOOOOOOOOOO
OOOOOOOOOOOOOOO
OOOOMOOOOOOOOOO
OOOOOOOOOOOOMOO
OOOOOOOOOOOOOOO
OOOOOOOOOOOOOOO
OOOOOOOOOOOOOOO
OOOOOOOOOOOOOOO
OOOOOOOOOOOOOOO
OOOOOOOOOOOOOOO
OOOOOOOMMMMMMMM
OOOOOOOMMMMMMMM
OOOOOOOMMMMMMMM
.
OOOOOOOOOOOOOOO
OOOOOOOOOOOOOOO
OOOOMOOOOOOOOOO
OOOOOOOOOOOOMOO
OOOOOOOOOOOOOOO
OOOOOOOOOOOOOOO
OOOOOOOOOOOOOOO
OOOOOOOOOOOOOOO
OOOOOOOOOOOOOOO
OOOOOOOOOOOOOOO
OOOOOOOMMMMMMMM
OOOOOOOMMMMMMMM
OOOOOOOMMMMMMMM