9 9 6
.
OOOOOOOOO
OOOOOOOOO
OOOOOOOOO
OOOOOOOOO
OOOOHHHHH
OOOOHHHHH
OOOOHHHHH
OOOOHHHHH
OOOOHHHHH
.
OOOOOOOOO
OOOOOOOOO
OOOOOOCOO
OOOOOOOOO
OOOOMMOMM
OOOOOOOMM
OOOOMMOOM
OOOOMMOMM
OOOOOOOMM
.
OOOOOOOOO
OOOOOHHHO
OOOOOHHHO
OOOOOHHHC
OOOOMMMMM
OOOCMMMMM
OOOOMMMOM
OOOOMMMMM
OOOOOOOMM
.
MMOOOOOOO
MMOOOMOMO
OOOOOMCMO
OOOOOMMMO
OOOOMMMMM
OOOOMMMOO
OOOOMMMOO
OPOOMMMMM
OOOOOOOMM
.
HHHHHHHHH
HHHHHHHHH
HHHHHHHHH
HHHHHHHHH
HHHHMMMMM
HHHHMMMOO
HHHHMMMOC
HHHHMMMMM
HHHHHHHMM
.
MMMMMMMMM
MMMMMMMMM
MMMMMMMMM
MMMMMMMMM
MMMMMMMMM
MMMMMMMMM
MMMMMMMMM
MMMMMMMMM
MMMMMMMMM