11 11 9
.
HHHHHHHHHHH
HHHHHHHHHHH
HHHHHHHHHHH
HHHHHHHHHHH
HHHHHHHHHHH
HHHHHHHHHHH
HHHHHHHHHHH
HHHHHHHHHHH
HHHHHHHHHHH
HHHHHHHHHHH
HHHHHHHHHHH
.
OOOOOOOOOOH
OHHHHHHHHHO
OHHHHHHHHHO
OHHHHHHHHHO
OHHHHHHHHHO
OHHHHHHHHHO
OHHHHHHHHHO
OHHHHHHHHHO
OHHHHHHHHHO
OHHHHHHHHHO
OOOOOOOOOHO
.
OOOOOOOOOOH
OHHHHHHHHHO
OHHHHHHHHHO
OHHHHHHHHHO
OHHHHHHHHHO
OHHHHHHHHHO
OHHHHHHHHHO
OHHHHHHHHHO
OHHHHHHHHHO
OHHHHHHHHHO
OOOOOOOOOHO
.
OOOOOOOOOOH
OHHHHHHHHHO
OHHHHHHHHHO
OHHHHHHHHHO
OHHHHHHHHHO
OHHHHHHHHHO
OHHHHHHHHHO
OHHHHHHHHHO
OHHHHHHHHHO
OHHHHHHHHHO
OOOOOOOOOHO
.
OOOOOOOOOOH
OHHHHHHHHHO
OHHHHHHHHHO
OHHHHHHHHHO
OHHHHHHHHHO
OHHHHHHHHHO
OHHHHHHHHHO
OHHHHHHHHHO
OHHHHHHHHHO
OHHHHHHHHHO
OOOOOOOOOHO
.
OOOOOOOOOOH
OHHHHHHHHHO
OHHHHHHHHHO
OHHHHHHHHHO
OHHHHHHHHHO
OHHHHHHHHHO
OHHHHHHHHHO
OHHHHHHHHHO
OHHHHHHHHHO
OHHHHHHHHHO
OOOOOOOOOHO
.
OOOOOOOOOOH
OHHHHHHHHHO
OHHHHHHHHHO
OHHHHHHHHHO
OHHHHHHHHHO
OHHHHHHHHHO
OHHHHHHHHHO
OHHHHHHHHHO
OHHHHHHHHHO
OHHHHHHHHHO
OOOOOOOOOHO
.
OOOOOOOOOOH
OHHHHHHHHHO
OHHHHHHHHHO
OHHHHHHHHHO
OHHHHHHHHHO
OHHHHHHHHHO
OHHHHHHHHHO
OHHHHHHHHHO
OHHHHHHHHHO
OHHHHHHHHHO
OOOOOOOOOHO
.
OOOOOOOOOOH
OHHHHHHHHHO
OHHHHHHHHHO
OHHHHHHHHHO
OHHHHHHHHHO
OHHHHHHHHHO
OHHHHHHHHHO
OHHHHHHHHHO
OHHHHHHHHHO
OHHHHHHHHHO
OOOOOOOOOHO
.
OOOOOOOOOOH
OHHHHHHHHHO
OHHHHHHHHHO
OHHHHHHHHHO
OHHHHHHHHHO
OHHHHHHHHHO
OHHHHHHHHHO
OHHHHHHHHHO
OHHHHHHHHHO
PHHHHHHHHHO
OOOOOOOOO1O
.
HHHHHHHHHHH
HHHHHHHHHHH
HHHHHHHHHHH
HHHHHHHHHHH
HHHHHHHHHHH
HHHHHHHHHHH
HHHHHHHHHHH
HHHHHHHHHHH
HHHHHHHHHHH
HHHHHHHHHHH
HHHHHHHHHHH