9 9 2
.
OOOOOOOOO
OHHOMMOCO
OHHOMMOOO
OOOOOOOOO
O11O22OXO
O11O22OXO
OOOOOOOOO
OZOOPOOQO
OOOOOOOOO
.
OHHHHHHHO
HHHHHHHHH
HHHHHHHHH
HHHHHHHHH
HHHHHHHHH
HHHHHHHHH
HHHHHHHHH
HHHHHHHHH
OIIIIIIIO